BBBBBBBBBBBBBBBBB
BWWWWWWWWWWWWWWWB
BW             WB
BW             WB
BW   WWW WWW   WB
BW   W     W   WB
BW   W  W  W   WB
BW   W     W   WB
BW   WWW WWW   WB
BW             WB
BW             WB
BWWWWWWWWWWWWWWWB
BBBBBBBBBBBBBBBBB