BBBBBBBBBBBBBBBBB
BWWWWWWWWWWWWWWWB
BW             WB
BW             WB
BW   WWWWWWW   WB
BW             WB
BW             WB
BW             WB
BW   WWWWWWW   WB
BW             WB
BW             WB
BWWWWWWWWWWWWWWWB
BBBBBBBBBBBBBBBBB